WWWWWWWWWWWWWWW
W...........P.W
W.......P.....W
W..P..........W
W........P....W
W.P...P.......W
W........P....W
W...P.........W
W.P.....P...PEW
WWWWWWWWWWWWWWW