WWWWWWWWWWWWWWW
WE..........P.W
W.......P.....W
W..P..........W
W........P....W
W.P...P.......W
W........P....W
W...P.........W
W.P.....P...P.W
WWWWWWWWWWWWWWW
